111111111111111
100C0000C0000C1
100000C0000P001
100001111110001
100000000000001
1000C00E0C000C1
100000000000001
111111111111111
